NO /home/ale/Cube3D/
SO /home/ale/Cube3D/textures_ids/south.txt
WE /home/ale/Cube3D/textures_ids/west.txt
EA /home/ale/Cube3D/textures_ids/east.txt


F 220,100,3
C 225,30,0

111
1111
1111
11N1
111
111
111
111
