NO /home/ale/Cube3D/textures_ids/nord.txt
SO /home/ale/Cube3D/textures_ids/south.txt
WE /home/ale/Cube3D/textures_ids/west.txt
EA /home/ale/Cube3D/textures_ids/east.txt


F 220,100,33
C 225,30,032

        1111111111111111111111111
        1000000000110000000000001
        1011000001110000000000001
        1001000000000000000000001
111111111011000001110000000000001
100000000011000001110111111111111
11110111111111011100000010001
11110111111111011101010010001
11000000110101011100000010001
10000000000000001100000010001
10000000000000001101010010001
1100000111010101101011110N0111
11110111 1110101 10000000001
11111111 1111111 111111111111