NO ./textures_ids/nord.png
SO ./textures_ids/south.png
WE ./textures_ids/west.png
EA ./textures_ids/east.png

F 220,100,0
C 225,30,0

         11111111111111111111111
        1000000000110000000000001
        1011000001110000000000001
        1001000000000000000000001
111111111011000001110000000000001
100000000011000001110111100011111
11110111111111011100000010001
11110111111111011101010010001111
11000000110101011100000010000001
100000000000000011000000100010N1
1000000000000000110101001000011
1100000111010101111101111000111
11110111 1110101 101111010001
11111111 1111111 11111111111