NO ./textures_ids/nord.png
SO ./textures_ids/south.png
WE ./textures_ids/west.png
EA ./textures_ids/east.png

F 100,100,0
C 110, ,254

111111
100101
101001
1100N1
111111