NO ./textures_ids/nord.png
SO ./textures_ids/south.png
111111
111111
WE ./textures_ids/west.png
EA ./textures_ids/east.png

F 118,118,118
C 110,177,255

111111
100101
101001
1100N1
111111