NO ./textures_ids/nord.png
SO ./textures_ids/south.png
WE ./textures_ids/west.png
EA ./textures_ids/east.png

F 118,118,118
C 110,177,255

111101
100101
101001
1100N1
111111