                              
                               
            1111111111111111111
            1000000000000000001
            1000000000000000001
            1000000000000000001
        11111000000000000000001
        1000000000000000001111
        11111000000000000000001
        1000000000000000001
        100P00000000000001
        1000000000000000001
        11111111111111111111111111111111111111111